Game Help | Achaea
Skip to content
Play more great MUDs from
Iron Realms Entertainment!
Aetolia
Lusternia
Menu
Play!
Game
Features Overview
City-States
Classes
Races
The Gods of Achaea
History & Mythos
Achaea Maps
Portal
Game Messages
Game News
Game Logs
Community
Forums
Using The Forums
Join us on Discord!
Achaea Wiki
Latest News
Help
Game Help Files
Frequently Asked Questions
Newbie Guides
How to Connect
Extensions
Support
Credits
Log In
Achaea Help Files
Achaea has hundreds of help files to you learn about Achaea. This is a copy of the in-game help file structure. HELP in-game will show you this same menu.
Help:
[
Return to Help Index
]
12.16.31 Map of Ulangi
___________________________________________________________________
|                                                                 |
|  1.
Ferry
to
Shastaan
/
Wilderness
room                         |
|
2
. To Cloud Forest                                             |
|
3
. Back to 2                                                   |
|                                                                 |
|  W   Water room     H
House
(Indoors)     C   Commshop        |
|  N
News
$
Shop
#   Room            |
|                                                                 |
|  - E-W    / SW-NE   < UP-DOWN                                   |
|                                                                 |
|  | N-S    \ NW-SE   ^ IN-OUT                                    |
|                                                                 |
|  Notes: Extended room connections (Example: ---- ) are for the  |
|         sake of spacing and do not imply rooms inbetween.       |
|_________________________________________________________________|
```````````````````````````````````````````````````````````````````
```
ULANGI
``````````````````````````````````````````````````````````
```````````````````````````````````````````````````````````````````
```````````````````````````````````````````````````````````````````
```````````````````````````````````````#---#---#```````````````````
```````````````````````````````````````<```````|```````````````````
`````````````````````````````````#-#```#`````C-N-$`````````````````
`````````````````````````````````|`````|```````|\``````````````````
`````````````````````````H^#`#```#`````#```````#`#`````````````````
````````````````````````````\|``/`\```/|\````````<`````````````````
`````````````````````````````#-#```#-#`#`#```H^#-#`````````````````
`````````````````````````````|`|````/|```|```|``/``````````````````
`````````````````#-----------#-#---#`#```#```H`#-#-#```````````````
````````````````/`````````````````````\`/|```<`|`|`````````````````
```````````````/```#-#<#```#-----------#`|```H`#`#`````````````````
``````````````/````<````\``|````````````\|`````````````````````````
`````````````/`````#-#```#<#`````````````#`````````````````````````
````````````/``````<`^```````````````````|`````````````````````````
`W`````````/```````2`#-#-#```````````````|`````````````````````````
`|````````/``````````````|```````````````|`````````````````````````
`W-W-W```#```````````````#```````````````|`````````````````````````
```|``\`/|```````````````|```````````````|`````````````````````````
```W```1-#`````````````#-#`#`````````````|`````````````````````````
````````\|````````````/|```|`````````````|`````````````````````````
`````````#```````````#`#---#-#<#```#`````|`````````````````````````
``````````\````````````````|````\`/``````|`````````````````````````
```````````\```````````````#`````#-#`````|`````````````````````````
````````````\`````````````/`````/|\``````|`````````````````````````
`````````````\```````````#`````#`#`#`````|`````````````````````````
``````````````\``````````|```````````````|`````````````````````````
```````````````\`````#-#-#```````````````|`````````````````````````
````````````````\````````````````````````|`````````````````````````
`````````````````\```````````````````````|`````````````````````````
``````````````````\``````````````````````|`````````````````````````
```````````````````\`````````````````````|`````````````````````````
````````````````````\````````````````````|`````````````````````````
`````````````````````\```````````````````|`````````````````````````
``````````````````````\``````````````````|`````````````````````````
```````````````````````\```````#`````````|`````````````````````````
````````````````````````\``````^`````````|`````````````````````````
`````````````````````````#---#`#---#```#`|`````````````````````````
``````````````````````````\``|/```/````|`|`````````````````````````
```````````````````````````#-#```#---#-#`|`````````````````````````
`````````````````````````````|``/|````\`\|`````````````````````````
`````````````````````````````#-#`#`````#-#`````````````````````````
`````````````````````````````|`|/`\```/````````````````````````````
`````````````````````````````#`#```\`#`````````````````````````````
````````````````````````````````````\|`````````````````````````````
`````````````````````````````````````#`````````````````````````````
```````````````````````````````````````````````````````````````````
```````````````````````````````````````````````````````````````````
```CLOUD FOREST````````````````````````````````````````````````````
```````````````````````````````````````````````````````````````````
```````````````````````````````````````````````````````````````````
```````````````#`````````#`````````````````````````````````````````
```````````````|````````/|`````````````````````````````````````````
```````````````#---#```/`|`````````````````````````````````````````
``````````````/`````\`/``|`````````````````````````````````````````
```````````3<#```````#---#`````````````````````````````````````````
`````````````|``````/```/``````````````````````````````````````````
```````````#-#-#---#```/```````````````````````````````````````````
```````````````````<\`/````````````````````````````````````````````
```````````````````#^#`````````````````````````````````````````````
`````````````````````|`````````````````````````````````````````````
`````````````````````#`````````````````````````````````````````````
```````````````````````````````````````````````````````````````````
```````````````````````````````````````````````````````````````````
Achaea is developed and published by
Iron Realms Entertainment.
Privacy Policy
Terms Of Service
Support
Follow us on Facebook!
We are using cookies to give you the best experience on our website.
You can find out more about which cookies we are using or switch them off in
settings
.
Accept
Scroll To Top
Close GDPR Cookie Settings
Privacy Overview
Strictly Necessary Cookies
Privacy Overview
This website uses cookies so that we can provide you with the best user experience possible. Cookie information is stored in your browser and performs functions such as recognising you when you return to our website and helping our team to understand which sections of the website you find most interesting and useful.
Strictly Necessary Cookies
Strictly Necessary Cookie should be enabled at all times so that we can save your preferences for cookie settings.
Enable or Disable Cookies
Enabled
Disabled
Enable All
Save Changes