Game Help | Achaea
Skip to content
Play more great MUDs from
Iron Realms Entertainment!
Aetolia
Lusternia
Menu
Play!
Game
Features Overview
City-States
Classes
Races
The Gods of Achaea
History & Mythos
Achaea Maps
Portal
Game Messages
Game News
Game Logs
Community
Forums
Using The Forums
Join us on Discord!
Achaea Wiki
Latest News
Help
Game Help Files
Frequently Asked Questions
Newbie Guides
How to Connect
Extensions
Support
Credits
Log In
Achaea Help Files
Achaea has hundreds of help files to you learn about Achaea. This is a copy of the in-game help file structure. HELP in-game will show you this same menu.
Help:
[
Return to Help Index
]
12.16.14 Map of the Aalen
______________________________________________________________________
| 1. to/from Lighthouse
2
. to
Cyrene
|
|                                                                      |
|
3
. Nolan, the
Ferryman
(to
Polyargos
& Shala'Khulia)                 |
|                                                                      |
|                                                                      |
| - E-W   / NE-SW   > Up-Down
X
NE-SW, NW-SE   % Water               |
|                                                                      |
| | N-S   \ NW-SE   ^ In-Out    + N-S, E-W       W
Wilderness
entrance |
|                                                                      |
| T the Tsol'aa village   M
vashnar
Mountains     B Beach              |
| J muurn Jungle          C muurn Cavern (river)  L Lake muurn         |
|                                                                      |
| NOTES: IF two rooms are touching, they are -not- connected by
exits
; |
| The Tsol'aa village is in the
trees
, nearly all rooms have up exits. |
|______________________________________________________________________|
````````````````````````````````````````````````````````````````````````
``````````````````>`````````````````````````````````````````````````````
```````#`````````M``````````````````````````````````````````````````````
```````|````````/```````````````````````````````````````````````````````
```````#-# #-#-W```#````````````````````````````````````````````````````
````````\ /|X|X|\``|````````````````````````````````````````````````````
`````````#-#-#-#-#-#-#-#````````````````````````````````````````````````
`````````|\|X /|/|/``|``````````````````````````````````````````````````
`````````#-#-# #-#```#``````````````````````````````````````````````````
````````/``|`|/|`|\`````````````````````````````````````````````````````
````````|#`|`|||`||`````````````````````````````````````````````````````
````````/|`|`|/|`|\`````````````````````````````````````````````````````
```````#-#-#-#-#-#-#````````````````````````````````````````````````````
```````|`|/`\ /`/|`|\```````````````````````````````````````````````````
```````#-#-#-#`#-#-#-#``````````````````````````````````````````````````
```````|/`/``|/`/|\|````````````````````````````````````````````````````
```````#-#-#-#-#`#-#-#``````````````````````````````````````````````````
```````|/```/|\`````\|\`````````````````````````````````````````````````
```````#`#`T-T-T-T```#-#````````````````````````````````````````````````
``````/|/``|X|X|X|```|`|\```````````````````````````````````````````````
`````W`#```T-T-T-T```#-#-#-W````````````````````````````````````````````
`````|\`\``|X|X|X|```|`|``\|``````````````````````````2`````````````````
`````#-#`#`T-T-T-T`#-#-#-#-#``````````````````````````|`````````````````
```````|/``|X|``````````\``|``````````````````````````L-----L```````````
`````#-#```T-T`````%-%```#-#`````````````````````````/```````\``````````
``````\|``/|``````/```\```/|``````````L-----L-------L`````````L`````````
```````#-#-#```%-%`#-#`%-#-#`````````/|``````\`````/`\````````|`````````
```````|/|``\`/`````\```/`\|``````L-L |```````\```/```\```````|`````````
```````#`#`#`%```#-#-#-#```#`````/```\|````````\`/`````\``````|`````````
````````\|\|/|``/|```|``\`/`````L`````L---------L-------L-----L`````````
`````````#`#`#-#`#`#-#-#-#`````/`\```/``````````|````````\```/`\````````
``````````\|/|``\`/|``/`````L-L```\`/```````````|````````/``/```\```````
```````````W`#-#`#`#-#`````/|``\```L````````````|```````/``/`````L``````
``````````/`\|`|``\`/`````/`|```\`/`\```````````|``````/```\`````|``````
```````#-#``||`#``|`|````/``|````L```\``````````|`````/````/`````|``````
``````/`````\|````\`/```L```|```/`\```\`````````|`````\```/``````|``````
`````#```````#-#-#-#```/`\``|``/```\```\````````|``````\`/```````|``````
`````|``````````\|/```L```\`|`/`````\```L-------L-------L` ______|``````
`````#```````````#````|````\|/```````\`/```````/```````/``|`````````````
`````|````````````````|`````L`L-------L```````/```````L```L`````````````
`````3````````````````|``````/`\```````\`````L```````/```/`\````````````
`````|````````````````L-----L```\```````\```/```````L```L```L```````````
`````B`````````````````\`````\```\```````\`/```````/`````\`/````````````
``````\`````````````````L-----L---L-------L-------L-------L`````````````
```````B```````````````````````\```\`````/```````/````````|`````````````
```````|````````````````````````\```\```/```````/`````````L`````````````
```````B`````````````````````````\```\`/```````/`````````/``````````````
````````\`````````````````````````L---L-------B-----B```/```````````````
`````````%`````````````````````````\```\```````\```/```/````````````````
````````/```````````````````````````\```\``/\```\`/```L`````````````````
```````B`````````````````````````````\```\/``L```B^1`/``````````````````
````````\`````````````````````````````\`````/`\``|``/```````````````````
`````````B`````````````````````````````\```/```\`|`/```#````````````````
`````````|``````````````````````````````\`/`````\|/````>````````````````
`````````B`````J`````````````````````````L-------L`````#````````````````
``````````\````|`````````````````````````````````^`````>````````````````
```````````B-J-J`````````````````````````````````C`````#````````````````
````````````/|`|````````````````````````````````/``````>````````````````
```````````J`|`J```````````````````````````````C`````1^#`#-#````````````
```````````|`|/```````````````````````````````/`````````>|`|\```````````
```````````|`J`````````````````````````````C-C```````````#`|`#-#```%````
```````````|/`````````````````````````````/`````````````/`\|/```\`/`\```
```````````J`````B```````````C-C-C-------C`````````````#```#`````#---%``
``````````/`````/```````````/````````````````````````````````````````>``
`````````%`````%`````````C-C`````````````````````````````````````````%``
`````````|````/`\```````/``|````````````````````````````````````````````
`````````%-%-%```%-%-%^C```C````````````````````````````````````````````
`````````|`````````|````````\```````````````````````````````````````````
`````````B`````````B`````````C-C````````````````````````````````````````
````````````````````````````````````````````````````````````````````````
Achaea is developed and published by
Iron Realms Entertainment.
Privacy Policy
Terms Of Service
Support
Follow us on Facebook!
We are using cookies to give you the best experience on our website.
You can find out more about which cookies we are using or switch them off in
settings
.
Accept
Scroll To Top
Close GDPR Cookie Settings
Privacy Overview
Strictly Necessary Cookies
Privacy Overview
This website uses cookies so that we can provide you with the best user experience possible. Cookie information is stored in your browser and performs functions such as recognising you when you return to our website and helping our team to understand which sections of the website you find most interesting and useful.
Strictly Necessary Cookies
Strictly Necessary Cookie should be enabled at all times so that we can save your preferences for cookie settings.
Enable or Disable Cookies
Enabled
Disabled
Enable All
Save Changes