Game Help | Achaea
Skip to content
Play more great MUDs from
Iron Realms Entertainment!
Aetolia
Lusternia
Menu
Play!
Game
Features Overview
City-States
Classes
Races
The Gods of Achaea
History & Mythos
Achaea Maps
Portal
Game Messages
Game News
Game Logs
Community
Forums
Using The Forums
Join us on Discord!
Achaea Wiki
Latest News
Help
Game Help Files
Frequently Asked Questions
Newbie Guides
How to Connect
Extensions
Support
Credits
Log In
Achaea Help Files
Achaea has hundreds of help files to you learn about Achaea. This is a copy of the in-game help file structure. HELP in-game will show you this same menu.
Help:
[
Return to Help Index
]
12.16.61 Map of Arcadia
______________________________________________________________________
| 1. to
Erymanthus
5
. Cafe                                   |
|
2
. to Vastar's temple
6
. Toy
Shop
|
|
3
. Tavern                  7. BookBindery                            |
| 4. Bakery                  8. Boutique                               |
|                                                                      |
| - E-W   / NE-SW   > Up-Down
X
NE-SW, NW-SE   % Water               |
|                                                                      |
| | N-S   \ NW-SE   ^ In-Out    + N-S, E-W       W
Wilderness
entrance |
|                                                                      |
|                                                                      |
| NOTE: IF two rooms are touching, they are -not- connected by
exits
.  |
|______________________________________________________________________|
```````````````````````````````````2````````````````````````````````````
```````````````````````````````````|````````````````````````````````````
```````````````````````````````````#````````````````````````````````````
```````````````````````````````````>````````````````````````````````````
`````````````````````````#`````````#`````````#``````````````````````````
````````````````````````>`\````````|````````/`>`````````````````````````
```````````````````````/```\````#``#```````/```\````````````````````````
``````````````````````>`````\```|``|``````/`````>```````````````````````
```````````````````````#`````#--#--#--#--#`````#````````````````````````
``````````````````````/``````|``|``|```#`|``````\```````````````````````
`````````````````````#```````|``#``|``>``|```````#``````````````````````
``````````````````````>``````|`````|`#```|``````>```````````````````````
```````````````````````#`````#`````|>````#`````#````````````````````````
``````````````````````/``````|`#---#---#`|``````\```````````````````````
`````````````````````#```````|`|`#`#`#`|`|```````#``````````````````````
``````````````````````>``````|`#``\>/``#`|``````>```````````````````````
```````````````````````#`````#`|```#```|`#`````#````````````````````````
``````````````````````>`\`````\|```|```|/`````/`>```````````````````````
`````````````````````/```\`````#---#---#`````/``\```````````````````````
`````````````````````>````\`````````````````/````>``````````````````````
`````````````````````#`````#`````6`7`8`````#`````#``````````````````````
````````````````````/``````|\````^`^`^`````|``````\`````````````````````
```````````````````#```````#`#-#-#-#-#-#-#-#```````#````````````````````
````````````````````>``````|```|```|```````|``````>`````````````````````
`````````````````````#`````#```#```#```````#`````#``````````````````````
````````````````````/```````\`````/ \`````/```````\`````````````````````
```````````````````#`````````#```#-#-#^5`#`````````#````````````````````
````````````````````>`````````\``|```|``/`````````>`````````````````````
`````````````````````#`````````#-#-#-#-#`````````#``````````````````````
````````````````````>`\`````````````````````````/`>`````````````````````
```````````````````/```\```````````#```````````/```\````````````````````
``````````````````>`````\`````````/|``````````/`````>```````````````````
`````````````````#```````#```````#-#-#```````#```````#``````````````````
``````````````````\``````|\``````>`>````````/|``````/```````````````````
```````````````````#`````#`#-#-#-#-#`#-#-#-#`#`````#````````````````````
````````````````````>````|``\```\| |`|/```/``|````>`````````````````````
`````````````````````#```#```#```# #`#```#```#```#``````````````````````
``````````````````````\```\```\```\|/```/```/```/```````````````````````
````````````````#``````#```#```#```#```#```#```#````````````````````````
````````````````>\``````>```\```\``|``/```/```>`````````````````````````
````````````````\`#-#----#```#`#`#`|`#```#```#``````````````````````````
````````````````/```````<`\```\|`|`|`|``/```/`>`````````````````````````
````````````````\```````/``#```#-#-#-#-#```#``\`````````````````````````
````````````````/``````/```|\`````````````/|```\````````````````````````
````````````````\`````/````#`#-#-#-#-#-#-#`#````\```````````````````````
````````````````/`````>````|```````|```````|`````>``````````````````````
````````````````\````#`````|```````#```````|`````#``````````````````````
````````````````/`````\````|``````/ \``````|````/```````````````````````
````````````````\``````#```#`4```#-#-#`````#```#````````````````````````
````````````````/```````>```\|```|```|````/```>`````````````````````````
````````````````\````````#```#```|`%`|```#```#``````````````````````````
````````````````/`````````\```\``|`|`|``/```/```````````````````````````
````````````````\``````````#```#-#-#-#-#```#````````````````````````````
````````````````/```````````>`````````````>`````````````````````````````
````````````````\````````````#```````````#``````````````````````````````
````````````````/`````````````\`````````/```````````````````````````````
````````````````>``````````````#-#-#-#-#````````````````````````````````
````````````````#`````#-#``````|```````|````````````````````````````````
`````````````````\```/`````````#```#```#````````````````````````````````
``````````````````#-#``````````|``/````|````````````````````````````````
````````````````````>``````````#`#`3```#````````````````````````````````
````````````````````#```````````\|`|``/`````````````````````````````````
`````````````````````\```````````#-#-#``````````````````````````````````
``````````````````````1`````````````````````````````````````````````````
``````````````````````>`````````````````````````````````````````````````
````````````````````````````````````````````````````````````````````````
Achaea is developed and published by
Iron Realms Entertainment.
Privacy Policy
Terms Of Service
Support
Follow us on Facebook!
We are using cookies to give you the best experience on our website.
You can find out more about which cookies we are using or switch them off in
settings
.
Accept
Scroll To Top
Close GDPR Cookie Settings
Privacy Overview
Strictly Necessary Cookies
Privacy Overview
This website uses cookies so that we can provide you with the best user experience possible. Cookie information is stored in your browser and performs functions such as recognising you when you return to our website and helping our team to understand which sections of the website you find most interesting and useful.
Strictly Necessary Cookies
Strictly Necessary Cookie should be enabled at all times so that we can save your preferences for cookie settings.
Enable or Disable Cookies
Enabled
Disabled
Enable All
Save Changes